20
11
Merci
 .----------------.  .----------------.  .----------------.  .----------------.  .----------------.  .----------------.  .----------------.  .----------------.  .----------------.  .----------------.  .----------------.  .----------------.  .----------------.  .-----------------. .----------------.  .----------------.  .----------------.  .----------------.  .----------------.  .----------------.  .----------------.  .----------------.  .----------------.  .----------------.  .----------------.  .----------------.  .----------------. 
| .--------------. || .--------------. || .--------------. || .--------------. || .--------------. || .--------------. || .--------------. || .--------------. || .--------------. || .--------------. || .--------------. || .--------------. || .--------------. || .--------------. || .--------------. || .--------------. || .--------------. || .--------------. || .--------------. || .--------------. || .--------------. || .--------------. || .--------------. || .--------------. || .--------------. || .--------------. || .--------------. |
| |      __      | || |   ______     | || |     ______   | || |  ________    | || |  _________   | || |  _________   | || |    ______    | || |  ____  ____  | || |     _____    | || |     _____    | || |  ___  ____   | || |   _____      | || | ____    ____ | || | ____  _____  | || |     ____     | || |   ______     | || |    ___       | || |  _______     | || |    _______   | || |  _________   | || | _____  _____ | || | ____   ____  | || | _____  _____ | || |  ____  ____  | || |  ____  ____  | || |   ________   | || |    ______    | |
| |     /  \     | || |  |_   _ \    | || |   .' ___  |  | || | |_   ___ `.  | || | |_   ___  |  | || | |_   ___  |  | || |  .' ___  |   | || | |_   ||   _| | || |    |_   _|   | || |    |_   _|   | || | |_  ||_  _|  | || |  |_   _|     | || ||_   \  /   _|| || ||_   \|_   _| | || |   .'    `.   | || |  |_   __ \   | || |  .'   '.     | || | |_   __ \    | || |   /  ___  |  | || | |  _   _  |  | || ||_   _||_   _|| || ||_  _| |_  _| | || ||_   _||_   _|| || | |_  _||_  _| | || | |_  _||_  _| | || |  |  __   _|  | || |   / _ __ `.  | |
| |    / /\ \    | || |    | |_) |   | || |  / .'   \_|  | || |   | |   `. \ | || |   | |_  \_|  | || |   | |_  \_|  | || | / .'   \_|   | || |   | |__| |   | || |      | |     | || |      | |     | || |   | |_/ /    | || |    | |       | || |  |   \/   |  | || |  |   \ | |   | || |  /  .--.  \  | || |    | |__) |  | || | /  .-.  \    | || |   | |__) |   | || |  |  (__ \_|  | || | |_/ | | \_|  | || |  | |    | |  | || |  \ \   / /   | || |  | | /\ | |  | || |   \ \  / /   | || |   \ \  / /   | || |  |_/  / /    | || |  |_/____) |  | |
| |   / ____ \   | || |    |  __'.   | || |  | |         | || |   | |    | | | || |   |  _|  _   | || |   |  _|      | || | | |    ____  | || |   |  __  |   | || |      | |     | || |   _  | |     | || |   |  __'.    | || |    | |   _   | || |  | |\  /| |  | || |  | |\ \| |   | || |  | |    | |  | || |    |  ___/   | || | | |   | |    | || |   |  __ /    | || |   '.___`-.   | || |     | |      | || |  | '    ' |  | || |   \ \ / /    | || |  | |/  \| |  | || |    > `' <    | || |    \ \/ /    | || |     .'.' _   | || |    /  ___.'  | |
| | _/ /    \ \_ | || |   _| |__) |  | || |  \ `.___.'\  | || |  _| |___.' / | || |  _| |___/ |  | || |  _| |_       | || | \ `.___]  _| | || |  _| |  | |_  | || |     _| |_    | || |  | |_' |     | || |  _| |  \ \_  | || |   _| |__/ |  | || | _| |_\/_| |_ | || | _| |_\   |_  | || |  \  `--'  /  | || |   _| |_      | || | \  `-'  \_   | || |  _| |  \ \_  | || |  |`\____) |  | || |    _| |_     | || |   \ `--' /   | || |    \ ' /     | || |  |   /\   |  | || |  _/ /'`\ \_  | || |    _|  |_    | || |   _/ /__/ |  | || |    |_|       | |
| ||____|  |____|| || |  |_______/   | || |   `._____.'  | || | |________.'  | || | |_________|  | || | |_____|      | || |  `._____.'   | || | |____||____| | || |    |_____|   | || |  `.___.'     | || | |____||____| | || |  |________|  | || ||_____||_____|| || ||_____|\____| | || |   `.____.'   | || |  |_____|     | || |  `.___.\__|  | || | |____| |___| | || |  |_______.'  | || |   |_____|    | || |    `.__.'    | || |     \_/      | || |  |__/  \__|  | || | |____||____| | || |   |______|   | || |  |________|  | || |    (_)       | |
| |              | || |              | || |              | || |              | || |              | || |              | || |              | || |              | || |              | || |              | || |              | || |              | || |              | || |              | || |              | || |              | || |              | || |              | || |              | || |              | || |              | || |              | || |              | || |              | || |              | || |              | || |              | |
| '--------------' || '--------------' || '--------------' || '--------------' || '--------------' || '--------------' || '--------------' || '--------------' || '--------------' || '--------------' || '--------------' || '--------------' || '--------------' || '--------------' || '--------------' || '--------------' || '--------------' || '--------------' || '--------------' || '--------------' || '--------------' || '--------------' || '--------------' || '--------------' || '--------------' || '--------------' || '--------------' |
 '----------------'  '----------------'  '----------------'  '----------------'  '----------------'  '----------------'  '----------------'  '----------------'  '----------------'  '----------------'  '----------------'  '----------------'  '----------------'  '----------------'  '----------------'  '----------------'  '----------------'  '----------------'  '----------------'  '----------------'  '----------------'  '----------------'  '----------------'  '----------------'  '----------------'  '----------------'  '----------------' 
