10 10 15
3 6
??????????????????????????????
#..............???????????????
#.#############???????????????
#.....T........???????????????
#.......................#.#..#
#.#######################.#..#
#.....##......##......#....###
#...####..##..##..##..#..#...#
#.........##......##.....#.C.#
##############################
